A2p0-E-E-E-E-E-E-R
D1r0-E-E-E-E-E-E-R
D1r0-E-E-E-E-E-E-R
R-R-R-R-R-R-E-R
D1b0-E-E-E-E-E-E-R
D1b0-E-E-E-E-E-E-R
A2p0-E-E-E-E-E-E-R
R-R-R-R-R-R-R-R